MV_1DUPRE|	Campo ou dado a ser gravado no prefixo do titulo. Quando o mesmo for gerado automaticamente pelo modulo de faturamento. 	|F
MV_ADTPRO|	Informe se gera adiantamento para motorista proprio.	|F
MV_AGECOTS|	Define se a cotacao gerada a partir do agendamento devera ser sempre para o solicitante.           	|F
MV_ALIANCA|	Define se utiliza Alianca no SIGATMS              	|F
MV_ALIQISS|	Aliquota do ISS em casos de prestacao de servicos.usando percentuais definidos pelo municipio.   	|5
MV_APSOLTR|	.T. -Os documentos seräo transf.automaticamente p/a Filial de debito destino;.F. -A filial de debito destino tera que aprovar todas as transf.solicit. 	|T
MV_ATIVCHG|	Atividade de Chegada de Viagem                    	|050
MV_ATIVDCA|	Atividade de Descarregamento                      	|051
MV_ATIVRTA|	Atividade de Retorno do Aeroporto                 	|052
MV_ATIVRTP|	Atividade de Retorno do Porto                     	| 
MV_ATIVSAI|	Atividade de Saida de Viagem                      	|049
MV_BLQPES|	Define o peso a ser utilizado no bloqueio das viagens, podendo ser configurado como: 1=Peso Real, 2=Peso Cubado e 3=Maior Peso.                       	|3
MV_CALNORI|	UTILIZADO PARA DEFINIR SE DEVERA SER VERIFICADO OS NIVEIS SUPERIORES DA REGIAO DE ORIGEM NO CALCULO DO FRETE	|T
MV_CANCFT|	PERMITE O CANCELAMENTO DE CTRC'S CONTIDOS EM UMA FATURA QUE JA TENHA SIDO MOVIMENTADA ?	|F
MV_CANCHST|	PERMITE EFETUAR O CANCELAMENTO DA FATURA E GRAVAR OU NAO O HISTORICO DE CANCELAMENTO	|T
MV_CARGDIR|	Determina a partir de qual peso em Kg sera considerada uma carga direta.                            	|10000
MV_CDHISAP|	Informe o codigo do historico de fechamento de racao de premio de seguros do TMS                 	| 
MV_CDRMUN|	CODIGO DA REGIAO DO MUNICIPIO	| 
MV_CDRORI|	Codigo da regiao origem da transportadora	|Q50308
MV_CLICOT|	Utiliza informacoes de preco do cliente           	|F
MV_CLIGEN|	Define o codigo do Cliente / Loja que serao utili-zados nos Contratos Genericos (Modulo TMS).       	|99999901
MV_COLSOCO|	GERA CONTRATO DE CARRETEIRO PARA VIAGENS DE COLETA SEM REGISTRO DE OCORRENCIA ?	|T
MV_COMPENT|	Codigo do Componente de Entrega                   	|01
MV_COMPIMP|	Codigo do componente de frete que sera utilizado para complemento de imposto.                       	| 
MV_COMPPDG|	Informe o codigo do componente de frete de pedagio	| 
MV_CONTDCA|	Efetua controle de descarregamento                	|F
MV_CONTHIS|	Controla alteracao da Tabela/Ajuste de Frete      	|T
MV_CONTVEI|	Controla Motoristas / Veiculos ?                  	|F
MV_COTVFEC|	Permitir a digitacao de valor fechado por componente na cotacao de frete.                           	|T
MV_CTCPREF|	DEFINE O PREFIXO UTILIZADO NO CONTRATO DE CARRETEIRO	|"C"+cFilant
MV_DATAFAT|	Data de emissao da fatura. Se nao for informado sera considerada a data atual do sistema.           	|  /  /    
MV_DESAWB|	Codigo de Despesa de AWB's                        	| 
MV_DESCTC|	Codigo de Despesa de contrato de carreteiro       	|000001
MV_DESPDG|	Codigo de Despesa de Pedagio                      	|000002
MV_DESPRE|	Codigo de Despesa de Contrato de Premio           	| 
MV_DOCNAVB|	Define os tipos de documentos que nao deveram ser averbados. Para a separacao devera ser utilizada avirgula.                                          	|A,B
MV_DOCVGE|	Determina se os enderecos/documentos podem ser vinculados a uma viagem atraves do carregamento   	|T
MV_DOMFERI|	DEVE CONSIDERAR DOMINGO COMO FERIADO QUNADO UTILIZADO A FUNCAO DTVALID() ?	|S
MV_EDIDIRE|	Diretorio de envio dos arquivos EDI	|C:\TOTVS\EDI\ENVIO
MV_EDIDIRR|	Diretorio de recebimento de arquivos edi.	|C:\TOTVS\EDI\RECEBE
MV_EDILOG|	Gera Log 	|F
MV_EDIRMOV|	Diretorio de backup dos arquivos recebidos edi	|C:\TOTVS\EDI\BACKUP
MV_ENTAER|	Define o Tipo de Transporte que realizara a Entrega de um Transporte Aereo; 1- Rodoviario / 2 -  Aereo                                                	|1
MV_ENCVDOC|	ENCERRA VIAGEM COM DOCUMENTOS EM TRANSITO EM QUALQUER FILIAL ? 0=NAO ENCERRA1=ENCERRA VIAGEM2=PERGUNTA	|1
MV_ENTSOCO|	GERA CONTRATO DE CARRETEIRO PARA VIAGENS DE ENTREGA SEM REGISTRO DE OCORRENCIA ?	|T
MV_ENCVIAG|	DEFINE SE DEVERA ENCERRAR A VIAGEM COM OCORRENCIA PARA TODOS OS DOCUMENTOS.	|1
MV_ENVIAG|	PERMITE VALIDAR SE O VEICULO ESTA EM USO PARA OUTRA VIAGEM, MESMO COM O CONTROLE DE VEICULOS DESLIGADO	|F
MV_ESPECIE|	Contem tipos de documentos fiscais utilizados na  emissao de notas fiscais    	|UNI=NF;1=CTE
MV_ESTADO|	Sigla do estado da empresa usuaria do Sistema, pa-ra efeito de calculo de ICMS (7, 12 ou 18%).     	|SP
MV_FATCUB|	Fator de cubagem padrao                           	|300
MV_FATPREF|	Prefixo do titulo da fatura de transporte         	|FAT
MV_FILDPC|	Define as filiais aliancas que efetuam redespac   para a filial atual.                              	| 
MV_FORGEN|	Define o codigo do Fornecedor / Loja que serao    utilizados nos contratos genericos (Modulo TMS)   	|99999901
MV_FORINSS|	Fornecedor padrao para titulos de INSS            	|INPS
MV_FORSEG|	Define o codigo do Fornecedor / Loja que serao  u-tilizados na geracao de titulos a pagar de seguro 	| 
MV_FORSEST|	Fornecedor padrao para titulos de SEST            	|SEST
MV_FRETEST|	Define aliquotas internas de ICMS de cada estado  a serem utilizadas nas notas de Conhecimento de   frete.Ex.: SP18MG18                               	| 
MV_GERADF|	 Gera Contas a Pagar do Adiantamento de Frete com valor superior ao valor do frete+pedagio          	|F
MV_GERCONT|	Gera Contrato de Carreteiro para Viagens de Ent   a / Coleta Nao Efetuadas ?                        	|T
MV_GEROPER|	Valida se o carregamento devera gerar as operacoes informadas no Servico Operacional do Servico de Negociacao                                          	|F
MV_GERTIT|	Gerar Contas a Pagar no Contrato de Carreteiro ?  	|T
MV_HORCOF|	Horario final de coletas da transportadora        	|18:00
MV_HORCOI|	Horario inicial de coletas da transportadora      	|08:00
MV_INCISS|	Verifica se o calculo do ISS devera ser embutido  	|T
MV_INTTMS|	Identifica se o Modulo do TMS esta integrado aos  outros modulos.                                   	|T
MV_ISS|	Natureza utilizada para Imposto s/Servico         	|"ISS"
MV_KMDIST|	Define que o calculo do Km será sempre pelo cadastro de Distancia para os calculos do frete a pagar.	|T
MV_KMOBRIG|	Obriga informar a quilometragem apos o apontamentodos registros das ocorrencias qdo todos os doctos da viagem estiverem com o status concluido.       	|F
MV_KMVEIOP|	Valida se Mostra Tela de Apontamento Manual de    gada / Saida de Viagens                           	|F
MV_LIMINSS|	Valor limite de retencäo para o INSS de pessoa    fisica                                            	|0
MV_LOCALIZ|	Indica se produtos poderao usar controle de localizacao fisica ou nao. (S)im ou (N)ao.              	|N
MV_MANVIAG|	PERMITE MANIFESTAR VIAGENS AINDA NAO DISPONIVEIS PARA A FILIAL CORRENTE	|F
MV_MOTGEN|	Codigo do motorista generico                      	|999999
MV_MULTEND|	Permite multiplo enderecamento para cada NF de   CLIente                                              	|F
MV_MUNIC|	Utilizado para identificar o codigo dado a  secre-taria das financas do municipio para recolher o   ISS.                                              	|MUNIC
MV_NATCTC|	Codigo da Natureza utilizado para geracao de titu-los a pagar provenientes de contratos de carretei-ros.                                              	|200001
MV_NATDEB|	Codigo da Natureza utilizado para geracao de titu-los a pagar provenientes de contratos de carretei-ros para a Filial de Debito                       	|2000001
MV_NATFAT|	Codigo da Natureza do titulo da fatura de transporte.                                               	|1000001
MV_NATFTRA|	Codigo da natureza de fatura de transporte. Informe uma natureza para cada tipo de transporte (1=Rodoviario;2=Aereo;3=Fluvial).                       	| 
MV_NATPDG|	Codigo da Natureza utilizado para geracao de titu-los a pagar provenientes de valores de pedagios.  	|2000002
MV_NUMFAT|	Numero sequencial de Faturas                      	|000000001
MV_OCODOC|	SE A CATEGORIA DA OCORRENCIA FOR POR DOCUMENTO, CONSIDERA TODOS OS DOCUMENTOS DA VIAGEM ?	|T
MV_OCORCOL|	Define a ocorrencia de coleta utilizado no apon   mento automatico de ocorrencia na geracao da nota 	|C002
MV_OCORENT|	Define a ocorrencia de entrega utilizada no apo   tamento automatico de ocorrencias no calculo de   frete	|E001
MV_OCORREE|	Define ocorrencias de reentrega	|E002
MV_PASSTAB|	Controle de Passos na Geracao de Tabelas de Free Reajuste de preco de Cliente                    	|100000
MV_PCANOP|	Define se na chegada/saida/encerramento de viagem existirem operacoes anteriores devera 0-Cancelar; 1=Perg.Antes de Canc.;2=Nao Canc.;3=Apont.Obrigat.	|0
MV_PESCOB|	Componente de frete que determina o peso cobrado  	| 
MV_PRCPROD|	O VALOR BASE PARA CALCULO DO FRETE SERA POR PRODUTO ?	|F
MV_PRDCTC|	Produto utilizado para Gerar Pedido de Compras    Contrato de Carreteiro (Pessoa Juridica)       	| 
MV_PRDDIV|	Define se podera ser informado Diversos Produto   nos programas do Modulo do TMS (Gestäo de Transpor	|T
MV_PREGPE|	Gera Premio para Motorista Proprio na Folha de    Pagamento ?                                       	|F
MV_PROGEN|	Define o codigo do produto que sera utilizado para obtencao de tabelas de frete ou seguro quando  não for encontrado o cod.produto solicitado  	| 
MV_REDESP|	Controla Redespacho no Transporte ?               	|T
MV_ROTGCOL|	Rota generica para coleta                         	| 
MV_ROTGENT|	Rota generica para entrega                        	|RT001
MV_ROTGTAB|	Rota generica para tabela de frete de carreteiros 	| 
MV_SELDOC|	Na consulta padrao, define se os documentos serao selecionados automaticamente na Viagem Modelo 2.  	|1
MV_SELFIS|	Filiais que usam o selo fiscal                    	| 
MV_SELSERV|	T ATIVA TELA DE SELECAO DE SERVICO NA INCLUSAO DO DOCUMENTO DO CLIENTE. F DESATIVA TELA.	|T
MV_SERTMS|	Define a descricäo dos servicos de transporte.    Ex: 1=Coleta;2=Transporte;3=Entrega.     	|1=Coleta;2=Transporte;3=Entrega
MV_SRVALI|	Servico de Transporte Alianca de segundo percur   	| 
MV_SRVFAT|	Define os servicos para o documento de fatura E   B1=001;C2=010, onde, B=Docto Transporte e 1=Tipo  	|B1=001;C2=010
MV_SVCENT|	Codigo do servico p/ carregamento de entrega do modulo TMS.                                         	|002
MV_SVCLOT|	Codigo do servico p/ conferencia de lote de notas fiscais do modulo TMS.                            	| 
MV_TESAWB|	Tipo de Entrada/Saida para a geracäo de AWB       	| 
MV_TESDD|	TES pre-determinado para geracao de movimentos de vasilhames ou mercadorias a serem transportadas r emetidos para terceiros.                          	|981
MV_TESDR|	TES pre-determinado para geracao de movimentos de vasilhames ou mercadorias a serem transportadas r emetidos por terceiros.                           	|481
MV_TIPFAT|	Tipo do titulo da fatura de transporte.           	|FT
MV_TMPCOL|	Tempo medio previsto para efetuar coletas         	|10:00
MV_TMPNORI|	Permite pesquisar em todos os niveis de região de origem.	|T
MV_TMSALOC|	Determina se devera verificar veiculos/motoristas utilizados no periodo informado no complemento de viagem.                                           	|F
MV_TMSBLVG|	O SISTEMA DEVERA BLOQUEAR A VIAGEM MESMO COM A EXISTENCIA DE UM DESBLOQUEIO ANTERIOR.	|F
MV_TMSCDPG|	CONSIDERA CONDICAO DE PAGAMENTO INFORMADA NO CADASTRO DO FORNECEDOR, PARA GERACAO DO CONTRATO DE CARRETEIRO POR VIAGEM.	|T
MV_TMSCFEC|	Indica se as funcionalidades de carga fechada estao ativas	|T
MV_TMSCRET|	Codigo de Retencao da DIRF usado para gerar o   Contrato de Carreteiro (Modulo de Transporte)     	|"0588"
MV_TMSCRTR|	CONTROLA O BLOQUEIO DE CREDITO NA SOLICITACAO DE TRANSFERENCIA DE DEBITO.	|F
MV_TMSDTVC|	DEFINE A DATA DE VIGENCIA DO CONTRATO DO FORNECEDOR UTILIZADA NA LIBERACAO DO CONTRATO 1=DATA DE EMISSAO DO CONTATO, 2=DATA DE LIBERACAO DO CONTRATO.	|1
MV_TMSDOC|	Define a descricao dos documentos de transporte   B e C.                                            	|B=ACT
MV_TMSEXP|	CONTROLA MODO EXPRESS	|F
MV_TMSFATU|	F NAO CONSIDERA A FILIAL CADASTRADA NO REGISTRO DE INDENIZACAO. T CONSIDERA A FILIAL CADASTRADA NO REGISTRO DE INDENIZACAO.	|F
MV_TMSFMSG|	Define se devera apresentar a mensagem para fatura geradas.                                          	|T
MV_TMSGREM|	Indica se os campos DTC_CODREM e DT6_LOJREM serao mantidos em tela, e validados automaticamente.    	|F
MV_TMSGRPC|	Indica se o Contrato de Carreteiro deve gerar PEDIDO de Compras                                     	|F
MV_TMSMFAT|	Modo de Faturamento do TMS. 1- Faturamento a pa   r do SE1; 2- Faturamento a partir do DT6          	|2
MV_TMSOCOL|	Permite informar a ocorrencia do documento em ou- tra filial.                                       	|F
MV_TMSPCLI|	PERMITE A BUSCA DE PONTOS POR SETOR, CONFIGURADO POR CODIGO DE CLIENTE	|T
MV_TMSRVOL|	RATEIO DO VALOR DO FRETE A PAGAR POR VOLUMES COLETADOS E/OU ENTREGUES	|F
MV_TMSUNFS|	Informe se a filial utiliza nota fiscal ou Conhecimento para Documentos de Armazenagem, Reentrega e Refaturamento.                                    	|F
MV_TMSVDEP|	VALOR POR DEPENDENTE	|0
MV_TMSUFPG|	INDICA O ESTADO QUE SERA UTILIZADO NA ESCRITURACAO DOS DOCUMENTOS DE TRANSPORTES SENDO QUE T=PAGADOR DO FRETE E F = DESTINATARIO DA MERCADORIA.	|F
MV_TMSVINF|	Permite informar o valor do frete na digitacao    Nota Fiscal                                       	|F
MV_TPNRNFS|	Define o tipo de controle de numeração de documentos (1=SX5,2=SXE/SXF)	|1
MV_TPTCTC|	Tipo de titulos a pagar provenientes de contratos de carreteiros.                                   	|C01
MV_TPTPDG|	Tipo de titulos a pagar provenientes de valores de pedagios.                                         	|PDG
MV_TPTPRE|	Tipo dos  titulos a pagar provenientes de contrato de Premio de Carreteiro                           	| 
MV_ULTDEST|	Define se utiliza o ultimo destino da coleta/     entrega para calculo do frete.                    	|T
MV_VEIGEN|	Codigo do veiculo generico de categoria "Cavalo"  	|99999999
MV_VERBMOT|	Codigo da Verba que sera utilizado na geracao d   premio do motorista proprio, na Folha de Pagto.   	| 
MV_VLDCOT|	Validade da cotacao de frete em dias              	|10
MV_TMSAGD2|	Aglutina itens da tabela SD2 ou SC6 ao efetuar calculo de Frete e Geracao de Fatura para documentos de apoio?                              	|F
MV_TMSANTT|	Numero do registro na ANTT.                       	| 
MV_TMSCDCA|	Permite o usuario retirar a obrigatoriedade de apontar a operacao descarregamento da viagem para que seja possivel efetuar o encerramento da viagem	|T
MV_TMSCTE|	Habilita o Ct-e - Conhecimento de transp.Eletronico	|T
MV_TMSD2NF|	Gerar item SD2 aglutinado para Nota Fiscal (tipo documento 5) no TMS                                	|T
MV_TMSDIAV|	Calcula a quantidade do compoenente Diaria (54 e  60) por Fornecedor e Veiculo                      	|T
MV_TMSDIND|	Numero de dias que sera permitido apontar uma ocorrencia de Indenizacao apos a entrega do documento                                         	|0
MV_TMSFOB|	Define se o tipo do frete para o consignatario ou despachante e FOB como sugestao.                  	|T
MV_TMSNFAT|	Considera a seqüencia do parametro MV_NUMFAT para numeracao dos titulos quando utilizado documentos de apoio.                                         	|T
MV_TMSGVT|	Tempo em seguntdos para execucao do refresh no painel de gestao de viagens. Em caso de "0" o refresh automatico e desabilitado.                        	|0
MV_TMSOPDG|	Indica se a integracao com Operadoras de Frota esta ativa. 0=Nao utiliza, 1=Somente Vale-Pedagio e 2=Vale Pedagio e Frota                             	|0
MV_TMSPROC|	Indica se o sistema deve usar as procedures instaladas no banco de dados para as rotinas do   TMS                                               	|F
MV_TMSPVOC|	Calcula o valor do componente de frete a pagar    "Peso/Volume" com base no apontamento da          ocorrencia.                                       	|F
MV_TPDCREE|	Quais os tipos de documentos de origem do TMS que Reentrega. 2 = CTRC e 5 = Nota Fiscal, (2;5) Aceita mais de um documento.              	|2
MV_ATIVRTA|	Atividade de Retorno do Aeroporto                 	|052
MV_ATIVRTP|	Atividade de Retorno do Porto                     	| 
MV_ATIVRDP|	Atividade de Saida para retirada do Reboque       	|055
MV_OBSREEN|	Observacao do documento de Reentrega.             	| 
MV_DATATMS|	 Data limite para as movimentacoes no modulo      	|  /  /    
MV_SERARM|	Informe um servico para cobranca de armazenagem relacionado no contrato do cliente.           	| 
MV_ATIVCHP|	Atividade de chegada do reboque no destino        	|054
MV_CREDCLI|	Utilizado na liberacao automatica de credito Utilize "L" para controle de credito por loja ou "C" para controle de credito por cliente. 	|L
